++++++++++++++++++++++++++
+   +   ++              ++
+     +     +++++++++++ ++
+ +    ++  ++++ +++ +++ ++
+ +   + + ++    +++  ++ ++
+          ++  ++  + ++ ++
+++++ + +      ++  + ++ ++
+++++ +++  + +  ++   ++ ++
+          + + S+ +  ++ ++
+++++ +  + + +     + ++ ++
+++++++++++++++++++++++ ++